1111111
1PDCC01
1101101
100C001
10011E1
1111111