11111111111111111111
1C00001000C000000001
10000010011010C00111
1P01C00001C0100C00E1
10000010011010C00111
10000000000000000001
11111111111111111111