11111111111111111111
1C00001000C00D000001
10000010011110C00111
1001C00001C0100000C1
1101000001001C011111
10000011000111111111
1P0110110000000000C1
10000011C00000100001
100001111100001110E1
11111111111111111111